XXXXXXXXXXXXXXXXXXXXXXXXXXXXXXXXXXXXXXXXXXXXXXXXXXXXXXXXXXXXXXXXXXXXXXXXXXXXXXXXXXXXXXXXXXXXXXXXXXXXXXXXXXXXXXXXXXXXXXXXXXXXXXXXXXXXXXXXXXXXXXXXXXXXXXXXXXXXX
XA                       BXA                            BXA   BXA         BXA         BXXXXXXXXXXXXXA        BXA        BXA44444444444444444444444444444444BX
X                         X                              X     X           X           X_____|_____X          X          X4444444444444444444444444444444444X
X                         X                              X     X           X           X_____|_____X          X          X4444444444444444444444444444444444X
X                         X                              X     X           X           X_____|_____X          X          X4444444444444444444444444444444444X
X                         X                              X     X           X           X_____|_____X          X          X4444444444444444444444444444444444X
X                         X                              X     X           X           X_____|_____X          X          X4444444444444444444444444444444444X
X                         X                              X     X           X           X_____|_____X          X          X4444444444444444444444444444444444X
X                         X                              X     X           X           X_____|_____X          X          X4444444444444444444444444444444444X
X                         X                              X     X           X           X_____|_____XC        DXC        DX4444444444444444444444444444444444X
X                         X                              X     X           X           X_____|_____XXXXIXXXXXXXXXXXXXIXXXX4444444444444444444444444444444444X
X                         X                              X     X           X           X_____|_____XA        BXA        BX4444444444444444444444444444444444X
X                         X                              X     X           X           X_____|_____X          X          X4444444444444444444444444444444444X
X                         X                              X     X           X           X_____|_____XC        DXC        DX4444444444444444444444444444444444X
X                         X                              X     X           X           X_____S_____XXXXXXXXXXXXXXXXXXXXXXX4444444444444444444444444444444444X
X                         X                              X     X           X           XYYYYYRYYYYYYYYYYYYYYYYYYYYYYYYYYYX4444444444444444444444444444444444X
X                         X                              X     X           X           XYYYYYRYYYYYYYYYYYYYYYYYYYYYYYYYYYX4444444444444444444444444444444444X
X                         X                              X     X           X           XYYYYYRYYYYYYYYYYYYYYYYYYYYYYYYYYYX4444444444444444444444444444444444X
XC                       DXC                            DXC   DXC         DXC         DXYYYYYRYYYYYYYYYYYYYYYYYYYYYYYYYYYX4444444444444444444444444444444444X
XXXXXXXXXXXXXXXXXXXXXXXXXXXXXXXXXXXXXXXXXXXXXXXXXXXXXXXXXXXXXXXXXXXXXXXXXXXXXXXXXXXXXXXXYYYYYRYYYYYYYYYYYYYYYYYYYYYYYYYYYX4444444444444444444444444444444444X
XA                BXYYYYYYYYYYYYYYYYYYYYYYYYYYYYYYYYYYYYYYYYYYYYYYYYYYYYYYYYYYYYYYYYYYYYYYYYYRYYYYYYYYYYYYYYYYYYYYYYYYYYYX4444444444444444444444444444444444X
X                  XYYYYYYYYYYYYYYYYYYYYYYYYYYYYYYYYYYYYYYYYYYYYYYYYYYYYYYYYYYYYYYYYYYYYYYYYYRYYYYYYYYYYYYYYYYYYYYYYYYYYYX4444444444444444444444444444444444X
X                  XYYYYYYYYYYYYYYYYYYYYYYYYYYYYYYYYYYYYYYYYYYYYYYYYYYYYYYYYYYYYYYYYYYYYYYYYYKRRRRRRRRRRRRRRRRRRRRRKYYYYYX4444444444444444444444444444444444X
X                  XYYYYYYYYYYYYYYYYYYYYYYYYYYYYYYYYYYYYYYYYYYYYYYYYYYYYYYYYYYYYYYYYYYYYYYYYYYYYYYYYYYYYYYYYYYYYYYYRYYYYYX4444444444444444444444444444444444X
X                  XYYYYYYYYYYYYYYYYYYYYYYYYYYYYYYYYYYYYYYYYYYYYYYYYYYYYYYYYYYYYYYYYYYYYYYYYYYYYYYYYYYYYYYYYYYYYYYYRYYYYYX4444444444444444444444444444444444X
X                  XXXXXXXXXXXXXXXXXXXXXXXXXXXXXXXXXXXXXXXXXXXXXXXXXXXXXXXXXXXXXXXXXXXXXYYYYYYYYYYYYYYYYYYYYYYYYYYYRYYYYYX4444444444444444444444444444444444X
X                  XA                 BXA         BXA         BXA         BXA         BXYYYYYYYYYYYYYYYYYYYYYYYYYYYRYYYYYX4444444444444444444444444444444444X
X                  X                   X           X           X           X           XYYYYYYYYYYYYYYYYYYYYYYYYYYYRYYYYYX4444444444444444444444444444444444X
X                  X                   X           X           X           X           XYYYYYYYYYYYYYYYYYYYYYYYYYYYRYYYYYX4444444444444444444444444444444444X
X                  X                   X           X           X           X           XYYYYYYYYYYYYYYYYYYYYYYYYYYYRYYYYYX4444444444444444444444444444444444X
X                  X                   X           X           X           X           XYYYYYYYYYYYYYYYYYYYYYYYYYYYRYYYYYX4444444444444444444444444444444444X
X                  X                   X           X           X           X           XYYYYYYYYYYYYYYYYYYYYYYYYYYYRYYYYYX4444444444444444444444444444444444X
X                  X                   X           X           X           X           XYYYYYYYYYYYYYYYYYYYYYYYYYYYKRRRRRE4444444444444444444444444444444444X
X                  X                   X           X           X           X           XYYYYYYYYYYYYYYYYYYYYYYYYYYYYYYYYYX4444444444444444444444444444444444X
XC                DXC                 DXC         DXC         DXC         DXC         DXYYYYYYYYYYYYYYYYYYYYYYYYYYYYYYYYYXC44444444444444444444444444444444DX
XXXXXXXXXXXXXXXXXXXXXXXXXXXXXXXXXXXXXXXXXXXXXXXXXXXXXXXXXXXXXXXXXXXXXXXXXXXXXXXXXXXXXXXXXXXXXXXXXXXXXXXXXXXXXXXXXXXXXXXXXXXXXXXXXXXXXXXXXXXXXXXXXXXXXXXXXXXXX