ZZZZZZZZZZZZZZZZZZZZZZZZXXXXXXXXXXXXXXXXXXXXXXXXXXXXXXXXXXXXXXXXXXXXXXXXXXXXXXXXXXXXXXXXXXX
ZZZZZZZZZZZZZZZZZZZZZZZZXA        BXA        BXA1111111111111111111BXA0000000000000000000BX
ZZZZZZZZZZZZZZZZZZZZZZZZX          X          X111111111111111111111X000000000000000000000X
ZZZZZZZZZZZZZZZZZZZZZZZZX          X          X111111111111111111111X000000000000000000000X
ZZZZZZZZZZZZZZZZZZZZZZZZX          X          X111111111111111111111X000000000000000000000X
ZZZZZZZZZZZZZZZZZZZZZZZZX          X          X111111111111111111111X000000000000000000000X
ZZZZZZZZZZZZZZZZZZZZZZZZX          X          X111111111111111111111X000000000000000000000X
XXXXXXXXXXXXXXXXXXXXXXXXX          X          X111111111111111111111X000000000000000000000X
XA         BXA         BX          X          X111111111111111111111X000000000000000000000X
X           X           X          I          X111111111111111111111X000000000000000000000X
X           X           X          X          X111111111111111111111X000000000000000000000X
X           X           XC        DXC        DX111111111111111111111X000000000000000000000X
X           X           XXXXXXXXXXXXXXXXXXXIXXX111111111111111111111X000000000000000000000X
XC         DXC         DXA             BXA   BX111111111111111111111X000000000000000000000X
XXXIXXXXXXXXXXXXXXXXXIXXX               X     X111111111111111111111X000000000000000000000X
XA      BX     XA      BX               I     X111111111111111111111X000000000000000000000X
X        X     X        X               X     X111111111111111111111X000000000000000000000X
X        X     X        X               X     X111111111111111111111X000000000000000000000X
XC      DXC   DXC      DXC             DXC   DXC1111111111111111111DXC00000000000000000000X
XXXXXXXXXXXXXXXXXXXXXXXXXXXXXXXXXXXXXXXXXXXXXXXXXXXXXXXXXXXXXXXEXXXXXXXXXEXXXXXXXXXXXXXXXXX
XYYYYYYYYYYYYYYYYYYYYYYYXYYYYYYYYYYYYYYYYYYYYYYYYYYYYYYYYYYYYYYRYYYYYYYYYRYYYYYYYYXA     BX
XYYYYYYYYYYYYYYYYYYYYYYYXYYYYYYYYYYYYYYYYYYYYYYYYYYYYYYYYYYYYYYRYYYYYYYYYRYYYYYYYYX       X
XYYYYYYYYYYYYYYYYYYYYRRRRRRRRRRRRRRRRRRRRRRRRRRRRRRRRRRRRRRRRRRURRRRRRRRRRYYYYYYYYX       X
XYYYYYYYYYYYYYYYYYYYYRYYIYYYYYYYYYYYYYYYYYYYYYYYYYYYYYYYYYYYYYYYYYYYYYYYYYYYYYYYYYX       X
XYYYYYYYYYYYYYYYYYYYYRYYXYYYYYYYYYYYYYYYYYYYYYYYYYYYYYYYYYYYYYYYYYYYYYYYYYYYYYYYYYXC     DX
XXXXXXXXXXXXXXXXXXYYYRYYXXXXXXXXXXXXXXXXXXXXXXXXXXXXXXXXXXXXXXXXXXXXXXXXXXXXXXXXXXXXXXXXXXX
X||||||||||||||||XYYYRYYXA  BXA  BXA         BXA        BXA        BXA   BXA             BX
X||||||||||||||||XYYYRYYX    X    X           X          X          X     X               X
X|||||||||||||||SRRRRRYYX    I    X           X          X          X     X               X
X||||||||||||||||XYYYYYYXC  DXC  DX           X          X          X     X               X
X||||||||||||||||XYYYYYYXXXXXXXXIXX           X          X          XC   DXC             DX
X||TTTTTTTTTTTTTTXYYYYYYXA       BX           X          X          XXXIXXXXXXXXXXXXXXXXXXX
X||||||||||||||||XYYYYYYX         X           X          X          XA        BXA        BX
X||||||||||||||||XYYYYYYX         X           X          X          X          I          X
X||||||||||||||||XYYYYYYX         X           X          X          XC        DX          X
X||||||||||||||||XYYYYYYX         X           X          X          XXXIXXXXXXXX          X
X||||||||||||||||XYYYYYYX         X           X          X          XA        BX          X
XXXXXXXXXXXXXXXXXXXXXXXXX         X           X          X          X          X          X
ZZZZZZZZZZZZZZZZZZZZZZZZX         X           X          X          X          X          X
ZZZZZZZZZZZZZZZZZZZZZZZZX         X           X          X          X          X          X
ZZZZZZZZZZZZZZZZZZZZZZZZX         X           X          X          X          X          X
ZZZZZZZZZZZZZZZZZZZZZZZZX         X           X          X          X          X          X
ZZZZZZZZZZZZZZZZZZZZZZZZX         X           X          X          X          X          X
ZZZZZZZZZZZZZZZZZZZZZZZZXC       DXC         DXC        DXC        DXC        DXC        DX
ZZZZZZZZZZZZZZZZZZZZZZZZXXXXXXXXXXXXXXXXXXXXXXXXXXXXXXXXXXXXXXXXXXXXXXXXXXXXXXXXXXXXXXXXXXX