XXXXXXXXXXXXXXXXXXXXXXXXXXXXXXXXXXXXXXXXXXXXXXXXXXXXXXXXXXXXXXXXXXXXXXXXXXXXXXXXXXXXXXXXXXXXXXXXXXXXXXXXXXXXXXXXXXXXXXXXXXXXXXXXXXXXXXXXXXXXXXXXX
XXXXXXXXXXXA         BXA         BXA                    BXA                    BXA        BXA        BXXXXXXXXXXXA55555555555555555555555555555BX
X_________X           X           X                      X                      X          X          X_________X5555555555555555555555555555555X
X_________X           X           X                      X                      X          X          X_________X5555555555555555555555555555555X
X____|____X           X           X                      X                      X          X          X____|____X5555555555555555555555555555555X
X____|____X           X           X                      X                      X          X          X____|____X5555555555555555555555555555555X
X____|____X           X           X                      X                      X          X          X____|____X5555555555555555555555555555555X
X____|____X           X           X                      X                      X          X          X____|____X5555555555555555555555555555555X
X____|____X           X           X                      X                      X          X          X____|____X5555555555555555555555555555555X
X____|____X           X           X                      X                      X          X          X____|____X5555555555555555555555555555555X
X____|____X           X           X                      X                      X          X          X____|____X5555555555555555555555555555555X
X____|____X           X           X                      X                      XC        DXC        DX____|____X5555555555555555555555555555555X
X____|____X           X           X                      X                      XXXXIXXXXXXXXXXXXXIXXXX____|____X5555555555555555555555555555555X
X____|____X           X           X                      X                      XA        BXA        BX____|____X5555555555555555555555555555555X
X____|____X           X           X                      X                      X          X          X____|____X5555555555555555555555555555555X
X____|____X           X           X                      X                      XC        DXC        DX_________X5555555555555555555555555555555X
X____|____X           X           X                      X                      XXXXXXXXXXXXXXXXXXXXXXXXXXXXXXXXX5555555555555555555555555555555X
X____S____X           X           X                      X                      XYYYYYYYYYYYYYYYYYYYYYYYYYYYYYYYX5555555555555555555555555555555X
XYYYYRYYYYX           X           X                      X                      XYYYYYYYYYYYYYYYYYYYYYYYYYYYYYYYX5555555555555555555555555555555X
XYYYYRYYYYX           X           X                      X                      XYYYYYYYYYYYYYYYYYYYYYYYYYYYYYYYX5555555555555555555555555555555X
XYYYYRYYYYXC         DXC         DXC                    DXC                    DXYYYYYYYYYYYYYYYYYYYYYYYYYYYYYYYX5555555555555555555555555555555X
XYYYYRYYYYYXXXXXXXXXXXXXXXXXXXXXXXXXXXXXXXXXXXXXXXXXXXXXXXXXXXXXXXXXXXXXXXXXXXXXYYYYYYYYYYYYYYYYYYYYYYYYYYYYYYYYX5555555555555555555555555555555X
XYYYYRYYYYYYYYYYYYYYYYYYYYYYYYYYYYYYYYYYYYYYYYYYYYYYYYYYYYYYYYYYYYYYYYYYYYYYYYYYYYYYYYYYYYYYYYYYYYYYYYYYYYYYYYYYX5555555555555555555555555555555X
XYYYYRYYYYYYYYYYYYYYYYYYYYYYYYYYYYYYYYYYYYYYYYYYYYYYYYYYYYYYYYYYYYYYYYYYYYYYYYYYYYYYYYYYYYYYYYYYYYYYYYYYYYYYYYYYX5555555555555555555555555555555X
XYYYYKRRRRRRRRRRRRRRRRRRRRRRRRRRRRRRRRRRRRRRRRRRRRRRRRRRRRRRRRRRRRRRRRRRRRRRRRRRRRRRRRRRRRRRRRRRRRRRRRRRRRKYYYYYX5555555555555555555555555555555X
XYYYYYYYYYYYYYYYYYYYYYYYYYYYYYYYYYYYYYYYYYYYYYYYYYYYYYYYYYYYYYYYYYYYYYYYYYYYYYYYYYYYYYYYYYYYYYYYYYYYYYYYYYRYYYYYX5555555555555555555555555555555X
XYYYYYYYYYYYYYYYYYYYYYYYYYYYYYYYYYYYYYYYYYYYYYYYYYYYYYYYYYYYYYYYYYYYYYYYYYYYYYYYYYYYYYYYYYYYYYYYYYYYYYYYYYRYYYYYX5555555555555555555555555555555X
XXXXXXXXXXXXXXXXXXXXXXXXXXXXXXXXXXXXXXXXXXXXXXXXXXXXXXXXXXXXXXXXXXXXXXXXXXXXXXXXYYYYYYYYYYYYYYYYYYYYYYYYYYRYYYYYX5555555555555555555555555555555X
XA              BXA              BXA                    BXA                   BXYYYYYYYYYYYYYYYYYYYYYYYYYYRYYYYYX5555555555555555555555555555555X
X                X                X                      X                     XYYYYYYYYYYYYYYYYYYYYYYYYYYRYYYYYX5555555555555555555555555555555X
X                X                X                      X                     XYYYYYYYYYYYYYYYYYYYYYYYYYYRYYYYYX5555555555555555555555555555555X
X                X                X                      X                     XYYYYYYYYYYYYYYYYYYYYYYYYYYRYYYYYX5555555555555555555555555555555X
X                X                X                      X                     XYYYYYYYYYYYYYYYYYYYYYYYYYYRYYYYYX5555555555555555555555555555555X
X                X                X                      X                     XYYYYYYYYYYYYYYYYYYYYYYYYYYRYYYYYX5555555555555555555555555555555X
X                X                X                      X                     XYYYYYYYYYYYYYYYYYYYYYYYYYYRYYYYYX5555555555555555555555555555555X
X                X                X                      X                     XYYYYYYYYYYYYYYYYYYYYYYYYYYRYYYYYX5555555555555555555555555555555X
X                X                X                      X                     XYYYYYYYYYYYYYYYYYYYYYYYYYYKRRRRRE5555555555555555555555555555555X
X                X                X                      X                     XYYYYYYYYYYYYYYYYYYYYYYYYYYYYYYYYX5555555555555555555555555555555X
XC              DXC              DXC                    DXC                   DXYYYYYYYYYYYYYYYYYYYYYYYYYYYYYYYYXC55555555555555555555555555555DX
XXXXXXXXXXXXXXXXXXXXXXXXXXXXXXXXXXXXXXXXXXXXXXXXXXXXXXXXXXXXXXXXXXXXXXXXXXXXXXXXXXXXXXXXXXXXXXXXXXXXXXXXXXXXXXXXXXXXXXXXXXXXXXXXXXXXXXXXXXXXXXXXX