XXXXXXXXXXXXXXXXXXXXXXXXXXXXXXXXXXXXXXXXXXXXXXXXXXXXXXXXXXXXXXXXXXXXXXXXXXXXXXXXXXXXXXXXXXXXXXXXXXXXXXXXXXXXXXXXXXXXXXXXXXXXXXXXXXXXXXXXXXXXXXXXXXXX
XXXXXXXXXXXA              BXA44444444444444444444BXA              BXA         BXA        BXA        BXXXXXXXXXXXA333333333333333333333333333333333BX
X_________X                X4444444444444444444444X                X           X          X          X_________X33333333333333333333333333333333333X
X_________X                X4444444444444444444444X                X           X          X          X_________X33333333333333333333333333333333333X
X____|____X                X4444444444444444444444X                X           X          X          X____|____X33333333333333333333333333333333333X
X____|____X                X4444444444444444444444X                X           X          X          X____|____X33333333333333333333333333333333333X
X____|____X                X4444444444444444444444X                X           X          X          X____|____X33333333333333333333333333333333333X
X____|____X                X4444444444444444444444X                X           X          X          X____|____X33333333333333333333333333333333333X
X____|____X                X4444444444444444444444X                X           X          X          X____|____X33333333333333333333333333333333333X
X____|____X                X4444444444444444444444X                X           X          X          X____|____X33333333333333333333333333333333333X
X____|____X                X4444444444444444444444X                X           X          X          X____|____X33333333333333333333333333333333333X
X____|____X                X4444444444444444444444X                X           XC        DXC        DX____|____X33333333333333333333333333333333333X
X____|____X                X4444444444444444444444X                X           XXXXIXXXXXXXXXXXXXIXXXX____|____X33333333333333333333333333333333333X
X____|____X                X4444444444444444444444X                X           XA        BXA        BX____|____X33333333333333333333333333333333333X
X____|____X                X4444444444444444444444X                X           X          X          X____|____X33333333333333333333333333333333333X
X____|____X                X4444444444444444444444X                X           XC        DXC        DX_________X33333333333333333333333333333333333X
X____|____X                X4444444444444444444444X                X           XXXXXXXXXXXXXXXXXXXXXXXXXXXXXXXXX33333333333333333333333333333333333X
X____S____X                X4444444444444444444444X                X           XYYYYYYYYYYYYYYYYYYYYYYYYYYYYYYYX33333333333333333333333333333333333X
XYYYYRYYYYX                X4444444444444444444444X                X           XYYYYYYYYYYYYYYYYYYYYYYYYYYYYYYYX33333333333333333333333333333333333X
XYYYYRYYYYX                X4444444444444444444444X                X           XYYYYYYYYYYYYYYYYYYYYYYYYYYYYYYYX33333333333333333333333333333333333X
XYYYYRYYYYXC              DXC44444444444444444444DXC              DXC         DXYYYYYYYYYYYYYYYYYYYYYYYYYYYYYYYXC333333333333333333333333333333333DX
XYYYYRYYYYYXXXXXXXXXXXXXXXXXXXXXXXXXXXXEXXXXXXXXXXXXXXXXXXXXXXXXXXXXXXXXXXXXXXXXYYYYYYYYYYYYYYYYYYYYYYYYYYYYYYYYXXXXEXXXXXXXXXXXXXXXXXXXXXXXXXXXXXXX
XYYYYRYYYYYYYYYYYYYYYYYYYYYYYYYYYYYYYYYRYYYYYYYYYYYYYYYYYYYYYYYYYYYYYYYYYYYYYYYYYYYYYYYYYYYYYYYYYYYYYYYYYYYYYYYYYYYYRYYYXYYYYYYYYYYYYYYXA         BX
XYYYYRYYYYYYYYYYYYYYYYYYYYYYYYYYYYYYYYYRYYYYYYYYYYYYYYYYYYYYYYYYYYYYYYYYYYYYYYYYYYYYYYYYYYYYYYYYYYYYYYYYYYYYYYYYYYYYRYYYXYYYYYYYYYYYYYYX           X
XYYYYRRRRRRRRRRRRRRRRRRRRRRRRRRRRRRRRRRURRRRRRRRRRRRRRRRRRRRRRRRRRRRRRRRRRRRRRRRRRRRRRRRRRRRRRRRRRRRRRRRRRRRRRRRRRRRRYYYXYYYYYYYYYYYYYYX           X
XYYYYYYYYYYYYYYYYYYYYYYYYYYYYYYYYYYYYYYYYYYYYYYYYYYYYYYYYYYYYYYYYYYYYYYYYYYYYYYYYYYYYYYYYYYYYYYYYYYYYYYYYYYYYYYYYYYYYYYYXYYYYYYYYYYYYYYX           X
XYYYYYYYYYYYYYYYYYYYYYYYYYYYYYYYYYYYYYYYYYYYYYYYYYYYYYYYYYYYYYYYYYYYYYYYYYYYYYYYYYYYYYYYYYYYYYYYYYYYYYYYYYYYYYYYYYYYYYYYXYYYYYYYYYYYYYYX           X
XXXXXXXXXXXXXXXXXXXXXXXXXXXXXXXXXXXXXXXXXXXXXXXXXXXXXXXXXXXXXXXXXXXXXXXXXXXXXXXXXXXXXXXXXXXXXXXXXXXXXXXXXXXXXXXXXXXXXXXXXXXXXXXXXXXXXXXX           X
XA              BXA              BXA              BXA              BXA        BXA                    BXA        BXA        BXA        BX           X
X                X                X                X                X          X                      X          X          X          X           X
X                X                X                X                X          X                      X          X          X          X           X
X                X                X                X                X          X                      X          X          X          X           X
X                X                X                X                X          X                      X          X          X          X           X
X                X                X                X                X          X                      X          X          X          X           X
X                X                X                X                X          X                      X          X          X          X           X
X                X                X                X                X          X                      X          X          X          X           X
X                X                X                X                X          X                      X          X          X          X           X
X                X                X                X                X          X                      X          X          X          X           X
XC              DXC              DXC              DXC              DXC        DXC                    DXC        DXC        DXC        DXC         DX
XXXXXXXXXXXXXXXXXXXXXXXXXXXXXXXXXXXXXXXXXXXXXXXXXXXXXXXXXXXXXXXXXXXXXXXXXXXXXXXXXXXXXXXXXXXXXXXXXXXXXXXXXXXXXXXXXXXXXXXXXXXXXXXXXXXXXXXXXXXXXXXXXXXX