XXXXXXXXXXXXXXXXXXXXXXXXXXXXXXXXXXXXXXXXXXXXXXXXXXXXXXXXXXXXXXXXXXXXXXXXXXXXXXXXXXXXXXXXXXXXXXXXXXXXXXXXXXXXXXXXXXXXXXXXXXXXXXXXXXXXXXXXXXXXXXXXXXXX
XA                    BXA  BXA              BXA              BXA              BXXXXXXXXXXXA         BXA        BXA33333333333333333333333333333333BX
X                      X    X                X                X                X_________X           X          X3333333333333333333333333333333333X
X                      X    X                X                X                X____|____X           X          X3333333333333333333333333333333333X
X                      X    X                X                X                X____|____X           X          X3333333333333333333333333333333333X
X                      X    X                X                X                X____|____X           X          X3333333333333333333333333333333333X
X                      X    X                X                X                X____|____X           X          X3333333333333333333333333333333333X
X                      X    X                X                X                X____|____X           X          X3333333333333333333333333333333333X
X                      X    X                X                X                X____|____X           X          X3333333333333333333333333333333333X
X                      X    X                X                X                X____|____X           X          X3333333333333333333333333333333333X
X                      X    X                X                X                X____|____X           X          X3333333333333333333333333333333333X
X                      X    X                X                X                X____|____X           X          X3333333333333333333333333333333333X
X                      X    X                X                X                X____|____X           X          X3333333333333333333333333333333333X
X                      X    X                X                X                X____S____X           XC        DX3333333333333333333333333333333333X
X                      X    X                X                X                XYYYYRYYYYX           XXXXXXXIXXXX3333333333333333333333333333333333X
X                      X    X                X                X                XYYYYRYYYYX           XA        BX3333333333333333333333333333333333X
X                      X    X                X                X                XYYYYRYYYYX           I       KRRE3333333333333333333333333333333333X
X                      X    X                X                X                XYYYYRYYYYX           X       R  X3333333333333333333333333333333333X
XC                    DXC  DXC              DXC              DXC              DXYYYYRYYYYXC         DXC      R DXC33333333333333333333333333333333DX
XXXXXXXXXXXXXXXXXXXXXXXXXXXXXXXXXXXXXXXXXXXXXXXXXXXXXXXXXXXXXXXXXXXXXXXXXXXXXXXXYYYYRYYYYXXXXXXXXXXXXXXXXXXXXRXXXXXXXXXXXXXXXXXXXXXXXXXXXXXXXXXXXXXX
XA              BXYYYYYYYYYYYYYYYYYYYYYYYYYYYYYYYYYYYYYYYYYYYYYYYYYYYYYYYYYYYYYYYYYYRYYYYYYYYYYYYYYYYYYYYYYYYRYYXA22222222222222222222222222222222BX
X                XYYYYYYYYYYYYYYYYYYYYYYYYYYYYYYYYYYYYYYYYYYYYYYYYYYYYYYYYYYYYYYYYYYRYYYYYYYYYYYYYYYYYYYYYYYYRYYX2222222222222222222222222222222222X
X                XYYYYYYYYYYYYYYYYYYYYYYYYYYYYYYYYYYYYYYYYYYYYYYYYYYYYYYYYYYYYYYYYYYKRRRRRRRRRRRRRRRRRRRRRRRRURRE2222222222222222222222222222222222X
X                XYYYYYYYYYYYYYYYYYYYYYYYYYYYYYYYYYYYYYYYYYYYYYYYYYYYYYYYYYYYYYYYYYYYYYYYYYYYYYYYYYYYYYYYYYYYRYYX2222222222222222222222222222222222X
X                XYYYYYYYYYYYYYYYYYYYYYYYYYYYYYYYYYYYYYYYYYYYYYYYYYYYYYYYYYYYYYYYYYYYYYYYYYYYYYYYYYYYYYYYYYYYRYYX2222222222222222222222222222222222X
X                XXXXXXXXXXXXXXXXXXXXXXXXXXXXXXXXXXXXXXXXXXXXXXXXXXXXXXXXXXXXXXXXXXXXXXXXXXXXXXXXXXXXXXXXXXXXEXXX2222222222222222222222222222222222X
X                XA              BXA        BXA        BXA        BXA        BXA        BXA11111111111111111111BX2222222222222222222222222222222222X
X                X                X          X          X          X          X          X1111111111111111111111X2222222222222222222222222222222222X
X                X                X          X          X          X          X          X1111111111111111111111X2222222222222222222222222222222222X
X                X                X          X          X          X          X          X1111111111111111111111X2222222222222222222222222222222222X
X                X                X          X          X          X          X          X1111111111111111111111X2222222222222222222222222222222222X
X                X                X          X          X          X          X          X1111111111111111111111X2222222222222222222222222222222222X
X                X                X          X          X          X          X          X1111111111111111111111X2222222222222222222222222222222222X
X                X                X          X          X          X          X          X1111111111111111111111X2222222222222222222222222222222222X
XC              DXC              DXC        DXC        DXC        DXC        DXC        DXC11111111111111111111DXC22222222222222222222222222222222DX
XXXXXXXXXXXXXXXXXXXXXXXXXXXXXXXXXXXXXXXXXXXXXXXXXXXXXXXXXXXXXXXXXXXXXXXXXXXXXXXXXXXXXXXXXXXXXXXXXXXXXXXXXXXXXXXXXXXXXXXXXXXXXXXXXXXXXXXXXXXXXXXXXXXX